11111111111111111111
10000010000000001000
10111010111111101011
10001010001000101010
11111011111010101011
00000010001010101000
11111010101110101111
10000010100000001000
10111010101111101011
10101010101000101010
10101011101011101010
10001000001000001000
10101111111011111010
10101000001010000010
10101010111011111111
10101010001000000000
10101011101011111110
10101010101010000010
10101110101010111010
10100000100010001010