1111111111111111111111
1111111111111111111111
0000010001000000000100
1111010101111111110101
0001010100000000000000
1101011101011111110101
0001010001010000000101
1111010111010111111101
0000000100010001000001
1101111101111111011111
0101000100000001010000
0101011111111101010111
0101010000000101010000
0101010111110101011111
1101000000010100010100
0101111111010111010101
0100000101010001010101
0111110101010101010101
0100010001010101000100
0111011101010101111111
0000000101010101000000
0111110101010101011111

