10101111111010111111
10101010001010100011
10101010101010111011
00101010101010000011
11101000101010111011
00101010101010101011
11101110101110101011
00000000100000101011
11111111111111101011
10100000000000001011
10101111111111111011
10101000000000000011
10101011111111111111
10100000000010000011
10111111111010111011
10001000000010001011
11101011111110101011
00001000000000101011
11111111111111101111
11111111111111141111