00000000101010001011
11111111101010111111
00000000001010000011
11111111101111101011
00001000101000001011
11111010101011111011
10000010101000100011
10111110101111101111
00100010000000100011
11111011111110101011
00000010000010101011
11111010111010101011
00101010101010101011
10101010101010111011
10001010001010001011
10101011111011101011
00101000000000001011
10111111111111111011
10100000000010000011
10101111111010111111