11111111111111111111
00000000000000001011
11111111111111101011
00001000000000001011
11101011111111111011
10101000000000001011
10101111111111101011
10000000001000100011
10101111101010111111
00101000001010100011
11101111111010101011
00100000000010101011
11101111111111101111
00000000000000000011
11101111101111111011
10101000101010000011
10101011111010111111
00101010101000100011
11101010001110101111
00001010101000101011
