10111011111111101110
00101000000000001000
11101011111111111111
10000000000000000000
11111111111111111111
00100000000010000000
10101111111010111111
10101000001010101000
10101011101010101010
10101010101010101010
10111010101010101010
10000010101010001010
11111110101010101010
10100000101010101010
10101110101010111010
00101000100000000010
10101111111111111110
00100000000000000000
11111111111111111111
11111111111111111111