10001010001010101010
10111011111010101011
10000000000010100000
11111111111010111111
00000000001010000010
11111111101011111010
00001000001000001000
11101111111111111111
10100000000000001000
10111111111111101011
10000000000000101010
11101111111111101010
00001000000000001010
11111011111111111011
00001010000000000000
10101010111111111111
10101010100000000000
10101010101111111111
10101010100000100000
10111011111111101110