1100010001000000000001
1101010101111111110111
1101010101000100000100
1101110101010101111101
1101000101010101000101
1101010101010101010101
1101010101010101010100
1101010101010101010101
1101010101010101010101
1101010101110101010101
1101010100010101010101
1101010111010101010101
1101010101000001010101
1101010101111111110101
1100010000000000000001
1111111111011111111111
1100010001000000000000
1101010101111111111111
1101000100000000000000
1111111111111111111111
1111111111111111111111
1111111111111111111111
