0101010101000001000001
1101110111111111011101
0001010000000000010001
0111010111111111111111
0100000000000000000000
0111111111111111111111
0001000000000100000000
0101011111110101111111
0101010000010101010000
0101010111010101010101
0101010101010101010101
0101110101010101010101
0100000101010100010101
0111111101010101010101
0101000001010101010101
1101011101010101110101
0001010001000000000101
1101011111111111111101
0001000000000000000000
1111111111111111111111
1111111111111111111111
1111111111111111111111