1101000001000100010100
1101110101111111110101
1101000100000100010101
1101010111110101010101
1100010100010001010101
1111110101010101010101
1101000001010101000100
1101111111011101111111
1100000001000001000100
1111111101111111110101
1100000101000000000101
1101110101011111111101
1101010101010001000001
1101010101010101011111
1101010101010101010000
1101010101010101010111
1101010101000101010000
1101010101110101011111
1100010100010101000001
1111110111011101111101
1100010001000000000001
1101010101111111110111