10111010111111111010
10100010000010001010
10101011111010101010
10001010001000101010
11111010101010101010
10100000101010100010
10111111101110111111
10000000100000100010
11111110111111111010
10000010100000000010
10111010101111111110
10101010101000100000
10101010101010101111
10101010101010101000
10101010101010101011
10101010100010101000
10101010111010101111
10001010001010100000
11111011101110111110
10001000100000000000
