0000000101010101000000
0111110101010101011111
0100010100010101010100
0101110111110101010111
0100000000000101000000
0111111111110101111111
0000000000010100000100
1111111111010111110101
0000010000010000010001
0111011111111111111111
0101000000000000010000
0101111111111111010111
0100000000000001010100
1111011111111111010101
0000010000000000010100
1111110111111111110111
0000010100000000000001
1101010101111111111111
0101010101000000000000
0101010101011111111111
0101010101000001000001
1101110111111111011101