0000010101010001010111
1111110101010111000111
0000000001010100010111
1111111111010101111111
0000000000010100000111
1111111111011111010111
0000010001010000010111
0111110101010111110111
0100000101010001000111
1101111101011111011111
0001000100000001000111
1111110111111101010111
0000000100000101010111
0111110101110101010111
0001010101010101010111
1101010101010101110111
0100010100010100010111
1101010111110111010111
0001010000000000010111
1101111111111111110111
0101000000000100000111
0101011111110101111111