11111111111111111111
00001000100000000010
11101010111111111010
00101010000000000000
10101110101111111010
00101000101000000010
11101011101011111110
00000010001000100000
10111110111111101111
10100010000000101000
10101111111110101011
10101000000010101000
10101011111010101111
10100000001010001010
10111111101011101010
10000010101000101010
11111010101010101010
10001000101010100010
11101110101010111111
00000010101010100000
