1111111111111111111111
1111111111111111111111
1100000100000000010000
1101110101111111010111
1100010100010001010100
1111110111110101010111
1000000100010101010000
1111110101011101011111
1100000101000000010000
1101110101011111010111
1101010101010001010101
1101010111010111010101
1100010000010000010001
1101011111110111110101
1101010000010100000101
1101010101110111111111
1101010100010000000001
1101010111010111111101
1101010101010100000101
1101011101010101110101
1101000001000100010100
1101110101111111110101