1111111111111111111111
1111111111111111111111
0000000000000000010111
0111111111111111010111
0000010000000000010111
0111010111111111110111
0101010000000000010111
0101011111111111010111
0100000000010001000111
1101011111010101111111
0001010000010101000111
1111011111110101010111
0001000000000101010111
1111011111111111011111
0000000000000000000111
0111011111011111110111
0101010001010100000111
0101010111110101111111
0001010101010001000111
1111010100011101011111
0000010101010001010111
1111110101010111000111