10101010111111111011
10101010100010000010
10111010101010111110
10100010101010100010
10101010101010101010
10101010101010101010
10101010101010101010
10101010101010101010
10101010111010101010
10101010001010101010
10101011101010101010
10101010100000101010
10101010111111111010
10001000000000000000
11111111101111111111
10001000100000000000
10101010111111111111
10100010000000000000
11111111111111111111
11111111111111111111