0101000000000100000111
0101011111110101111111
0101010100010101000111
1101010101010101110111
0001010101010100000111
1111010001010101110111
0001010101010101010111
1111011101011101010111
0000000001000001010111
0111111111111111010111
0101000000000000010111
0101011111111111110111
0101010000000000000111
0101010111111111111111
0101000000000100000111
0101111111110101110111
0100010000000100010111
0111010111111101010111
0000010000000001010111
1111111111111111011111
1111111111111111411111
1111111111111111111111